1111111111
1P0000CC01
11C1C1C1C1
10000000E1
1111111111