111111111111111111111111111
1P0000C0001111000C0000C00E1
101111101111101111101111101
1C0000C0000000000C0000C0001
101110111101110111101110111
1000100001C0001C00010001001
111011110111101111011101111
1C001C000000M000000C001C001
101111101111101111101111101
1C0000C0001111000C0000C0001
101111101111101111101111101
1C0000C0000000000C0000C0001
101110111101110111101110111
1M00C0001C0001C0001000C00M1
111011110111101111011101111
1C000C000000M000000C000C001
101111101111101111101111101
1C0000C0001111000C0000C0001
111111111111111111111111111
