1111111111111111111111111111111111
1E0000000M00000C00100C000000000001
101001010M100000101001000000M10101
101001001M101010100001000000010101
1P0000000C00C0001010000000000000C1
1111111111111111111111111111111111